**********************
*         *         *
*    *    *  ***    *
*    *    *    *    *
*    *    *    *    *
*    *    *    *    *
*S   *       E *    *
***********************
