*********************
S     *         **  *
* *** * ******  *****
*   *   *       * * *
*** *****   ***** * *
*   ****           E*
*********************
