*********************
S     *         **  *
* *** * ******  *****
*   *   *       * * *
*** * *     ***** * *
*   * * *           E*
*********************
